10 10
UFFFFFFFFF
FFFFFFFFUF
FFFFFFFFFF
FFFFFUFFFF
FFFHFFFFFF
FUFFFFFFFF
FFFFFFFUFF
FFFFFFFFFF
FFFFFUFFFF
FFFFFFFFFF